27,27,27,27,27,27,27,27,27,27,27,27,11,12,13,14,27,27,27,27,27,27,27,27,27,27,27,27,27,27
27,27,27,27,27,27,27,11,12,13,14,27,29,30,31,32,27,11,12,13,14,27,27,27,27,27,27,27,27,27
27,27,27,27,27,27,27,29,30,31,32,27,47,48,49,50,27,29,30,31,32,27,27,27,27,27,27,27,27,27
27,27,27,27,27,27,27,47,48,49,50,27,65,66,67,68,27,47,48,49,50,27,27,27,27,27,27,27,27,27
27,27,27,27,27,27,27,65,66,67,68,27,83,84,85,86,27,65,66,67,68,27,27,27,27,27,27,27,27,27
27,27,27,27,27,27,27,83,84,85,86,27,101,102,103,104,27,83,84,85,86,27,27,27,27,27,27,27,27,27
27,27,27,27,27,27,27,101,102,103,104,27,27,27,27,27,27,101,102,103,104,27,27,27,27,27,27,27,27,27
27,27,27,27,27,27,27,27,27,27,27,27,27,27,27,27,27,27,27,27,27,27,27,27,27,27,27,27,27,27
27,27,27,27,27,27,27,27,27,27,27,27,27,27,27,27,27,27,27,27,27,27,27,27,27,27,27,27,27,27
27,27,27,27,27,27,27,27,27,27,27,27,27,27,27,27,27,27,27,27,27,27,27,27,27,27,27,27,27,27
27,27,27,27,27,27,27,27,27,27,27,27,27,27,27,27,27,27,27,27,27,27,27,27,27,27,27,27,27,27
27,27,27,27,27,27,27,27,27,27,27,27,27,27,27,27,27,27,27,27,27,27,27,27,27,27,27,27,27,27
27,27,27,27,27,27,27,27,27,27,27,27,27,27,27,27,27,27,27,27,27,27,27,27,27,27,27,27,27,27
27,27,27,27,27,27,27,27,27,27,27,27,27,27,27,27,27,27,27,27,27,27,27,27,27,27,27,27,27,27
27,27,27,27,27,27,27,27,27,27,27,27,27,27,27,27,27,27,27,27,27,27,27,27,27,27,27,27,27,27
